%%%%%%%%%%%%%%%%
%S             %
% %%%%%%%%%%%% %
% %          % %
% % %%%%%%%% % %
% % %      % % %
% % % %%%% % % %
% % % %G % % % %
% % % %%% % % % %
% % %     % % % %
% % %%%%%%%%% % %
% %           % %
% %%%%%%%%%%%%% %
%               %
%%%%%%%%%%%%%%%%
