%%%%%
%S  %
% % %
%  G%
%%%%%
