%%%%%
%S% %
% % %
% %G%
%%%%%
